36
    O O 37 F
    O O 45 T
    D G 1
    _ W _ _ _ _ _
    _ _ E _ _ _ _
    _ _ _ _ _ G _
    _ _ _ H _ _ _
    _ _ B _ _ _ _
    M _ _ _ _ _ _

5 C
    O O 2 T
    M
    D G 35 F
    L _ _ _ _ _ _
    _ _ _ _ _ X _
    _ Y _ _ _ _ _
    _ _ I _ _ _ _
    _ _ _ _ M _ _
    _ _ _ _ _ _ O